1111111111110111111111111
1000001111110110000000001
1011100000100110111111101
1011101101110110100000001
1000001101110110111111101
1011111101110000000000001
1011111101110111111011101
1011111101110111111011111
1000000000000111111011111
1111011111110111111011111
1111011111110111111011111
1111011111000001111011111
0000000011000001100000000
1011111011000001101111101
1011111011111111101111101
1000000000000000001111101
1011111111111110111111101
1011111111111110111111101
1011111111111110111111101
1000000011111110111111101
1011111000000000000000001
1011111111110111111111101
1011111111110000000000001
1000000000000111111111111
1111111111110111111111111
